24,24
111111111111111111111111
111111110000000000000111
111100000000000000000001
111100000000000000000001
111000000000000000000221
111000000000000000002221
110000000000000000000221
110000000000000000000001
110000000000000000000001
110000000000000000011111
110000000000111111111111
100000000001111111111111
100000000001110000000001
100000000000110000000001
100000000000110000000001
100000000000000000000001
100000000000000000000001
100000000000000001100001
100000000000000111000001
110000000000011100000001
110000000000010000000001
111000000000110000000001
111100000011110P00000001
111111111111111111111111